1111111111111111111111111111111111
1000000000000000000000000000000001
1000000000000000000000000000000001
100000000000000000000000000000F4E1
100000000000000000000000C0J00LGGR1
10000000000000000C000S0JJ00007DD81
10000000000000005LGGGRM000M007DD81
100000000004000CLDDDDDGGGGGGGDLGR1
1P0S0C0LGGGRM00LDDDDDDDDDDDDDLDD81
1LGR0J07DDDDGGGDDDDLGGRDDDDDLDDD81
17D80507DLGRDDDDDDLDDDDRDDDLDDDD81
17DDGGGDLDD8DDDDLGDDDDDDGGGDDDDD81
17DLGRDD7DD8GRDLDDDDDDDDDDDDDDDD81
1WWWWWWWWWWWWWWWWWWWWWWWWWWWWWWWW1
1ZZZZZZZZZZZZZZZZZZZZZZZZZZZZZZZZ1
1111111111111111111111111111111111